Name,Math,Science,English,History,Total,Grade
Ananya,78,84,90,76,328,A
Ravi,65,70,72,68,275,B
Priya,88,92,91,89,360,A
Kunal,56,60,58,54,228,C
Sneha,90,86,92,94,362,A
Aman,45,49,50,52,196,D
Ishita,75,80,79,77,311,B
Dev,39,41,40,38,158,F
Riya,82,85,88,86,341,A
Arjun,70,72,74,76,292,B
